ARE	AA R
ARE(2)	ER
BOOKS	B UH K S
BOTTLES	B AA T AH L Z
COLOR	K AH L ER
COLOR(2)	K AO L ER
CUPS	K AH P S
HIGHLIGHT	HH AY L AY T
HOW	HH AW
IS	IH Z
LAPTOPS	L AE P T AA P S
MANY	M EH N IY
OF	AH V
PENS	P EH N Z
PHONES	F OW N Z
THE	DH AH
THE(2)	DH IY
THERE	DH EH R
WHAT	W AH T
WHAT(2)	HH W AH T
